გავიხსენებდით	V,1,PL,COND
გავიხსენოთ	V,1,PL,IMP
გავიხსენებთ	V,1,PL,IND,FUT
ვიხსენებდით	V,1,PL,IND,IPFV
გაგვიხსენებია	V,1,PL,IND,PRF
ვიხსენებთ	V,1,PL,IND,PRS
გავიხსენეთ	V,1,PL,IND,PST,PFV
გაგვეხსენებინა	V,1,PL,IND,PST,PRF
გავიხსენოთ	V,1,PL,OPT
გავიხსენებდეთ	V,1,PL,SBJV,FUT
გაგვეხსენებინოს	V,1,PL,SBJV,PRF
ვიხსენებდეთ	V,1,PL,SBJV,PRS
გავიხსენებდი	V,1,SG,COND
გავიხსენებ	V,1,SG,IND,FUT
ვიხსენებდი	V,1,SG,IND,IPFV
გამიხსენებია	V,1,SG,IND,PRF
ვიხსენებ	V,1,SG,IND,PRS
გავიხსენე	V,1,SG,IND,PST,PFV
გამეხსენებინა	V,1,SG,IND,PST,PRF
გავიხსენო	V,1,SG,OPT
გავიხსენებდე	V,1,SG,SBJV,FUT
გამეხსენებინოს	V,1,SG,SBJV,PRF
ვიხსენებდე	V,1,SG,SBJV,PRS
გაიხსენებდით	V,2,PL,COND
გაიხსენეთ	V,2,PL,IMP
გაიხსენებთ	V,2,PL,IND,FUT
იხსენებდით	V,2,PL,IND,IPFV
გაგიხსენებიათ	V,2,PL,IND,PRF
იხსენებთ	V,2,PL,IND,PRS
გაიხსენეთ	V,2,PL,IND,PST,PFV
გაგეხსენებინათ	V,2,PL,IND,PST,PRF
გაიხსენოთ	V,2,PL,OPT
გაიხსენებდეთ	V,2,PL,SBJV,FUT
გაგეხსენებინოთ	V,2,PL,SBJV,PRF
იხსენებდეთ	V,2,PL,SBJV,PRS
გაიხსენებდი	V,2,SG,COND
გაიხსენე	V,2,SG,IMP
გაიხსენებ	V,2,SG,IND,FUT
იხსენებდი	V,2,SG,IND,IPFV
გაგიხსენებია	V,2,SG,IND,PRF
იხსენებ	V,2,SG,IND,PRS
გაიხსენე	V,2,SG,IND,PST,PFV
გაგეხსენებინა	V,2,SG,IND,PST,PRF
გაიხსენო	V,2,SG,OPT
გაიხსენებდე	V,2,SG,SBJV,FUT
გაგეხსენებინოს	V,2,SG,SBJV,PRF
იხსენებდე	V,2,SG,SBJV,PRS
გაიხსენებდნენ	V,3,PL,COND
გაიხსენონ	V,3,PL,IMP
გაიხსენებენ	V,3,PL,IND,FUT
იხსენებდნენ	V,3,PL,IND,IPFV
გაუხსენებიათ	V,3,PL,IND,PRF
იხსენებენ	V,3,PL,IND,PRS
გაიხსენეს	V,3,PL,IND,PST,PFV
გაეხსენებინათ	V,3,PL,IND,PST,PRF
გაიხსენონ	V,3,PL,OPT
გაიხსენებდნენ	V,3,PL,SBJV,FUT
გაეხსენებინოთ	V,3,PL,SBJV,PRF
იხსენებდნენ	V,3,PL,SBJV,PRS
გაიხსენებდა	V,3,SG,COND
გაიხსენოს	V,3,SG,IMP
გაიხსენებს	V,3,SG,IND,FUT
იხსენებდა	V,3,SG,IND,IPFV
გაუხსენებია	V,3,SG,IND,PRF
იხსენებს	V,3,SG,IND,PRS
გაიხსენა	V,3,SG,IND,PST,PFV
გაეხსენებინა	V,3,SG,IND,PST,PRF
გაიხსენოს	V,3,SG,OPT
გაიხსენებდეს	V,3,SG,SBJV,FUT
გაეხსენებინოს	V,3,SG,SBJV,PRF
იხსენებდეს	V,3,SG,SBJV,PRS

დავიმტკიცებდით	V,1,PL,COND
დავიმტკიცოთ	V,1,PL,IMP
დავიმტკიცებთ	V,1,PL,IND,FUT
ვიმტკიცებდით	V,1,PL,IND,IPFV
დაგვიმტკიცებია	V,1,PL,IND,PRF
ვიმტკიცებთ	V,1,PL,IND,PRS
დავიმტკიცეთ	V,1,PL,IND,PST,PFV
დაგვემტკიცებინა	V,1,PL,IND,PST,PRF
დავიმტკიცოთ	V,1,PL,OPT
დავიმტკიცებდეთ	V,1,PL,SBJV,FUT
დაგვემტკიცებინოს	V,1,PL,SBJV,PRF
ვიმტკიცებდეთ	V,1,PL,SBJV,PRS
დავიმტკიცებდი	V,1,SG,COND
დავიმტკიცებ	V,1,SG,IND,FUT
ვიმტკიცებდი	V,1,SG,IND,IPFV
დამიმტკიცებია	V,1,SG,IND,PRF
ვიმტკიცებ	V,1,SG,IND,PRS
დავიმტკიცე	V,1,SG,IND,PST,PFV
დამემტკიცებინა	V,1,SG,IND,PST,PRF
დავიმტკიცო	V,1,SG,OPT
დავიმტკიცებდე	V,1,SG,SBJV,FUT
დამემტკიცებინოს	V,1,SG,SBJV,PRF
ვიმტკიცებდე	V,1,SG,SBJV,PRS
დაიმტკიცებდით	V,2,PL,COND
დაიმტკიცეთ	V,2,PL,IMP
დაიმტკიცებთ	V,2,PL,IND,FUT
იმტკიცებდით	V,2,PL,IND,IPFV
დაგიმტკიცებიათ	V,2,PL,IND,PRF
იმტკიცებთ	V,2,PL,IND,PRS
დაიმტკიცეთ	V,2,PL,IND,PST,PFV
დაგემტკიცებინათ	V,2,PL,IND,PST,PRF
დაიმტკიცოთ	V,2,PL,OPT
დაიმტკიცებდეთ	V,2,PL,SBJV,FUT
დაგემტკიცებინოთ	V,2,PL,SBJV,PRF
იმტკიცებდეთ	V,2,PL,SBJV,PRS
დაიმტკიცებდი	V,2,SG,COND
დაიმტკიცე	V,2,SG,IMP
დაიმტკიცებ	V,2,SG,IND,FUT
იმტკიცებდი	V,2,SG,IND,IPFV
დაგიმტკიცებია	V,2,SG,IND,PRF
იმტკიცებ	V,2,SG,IND,PRS
დაიმტკიცე	V,2,SG,IND,PST,PFV
დაგემტკიცებინა	V,2,SG,IND,PST,PRF
დაიმტკიცო	V,2,SG,OPT
დაიმტკიცებდე	V,2,SG,SBJV,FUT
დაგემტკიცებინოს	V,2,SG,SBJV,PRF
იმტკიცებდე	V,2,SG,SBJV,PRS
დაიმტკიცებდნენ	V,3,PL,COND
დაიმტკიცონ	V,3,PL,IMP
დაიმტკიცებენ	V,3,PL,IND,FUT
იმტკიცებდნენ	V,3,PL,IND,IPFV
დაუმტკიცებიათ	V,3,PL,IND,PRF
იმტკიცებენ	V,3,PL,IND,PRS
დაიმტკიცეს	V,3,PL,IND,PST,PFV
დაემტკიცებინათ	V,3,PL,IND,PST,PRF
დაიმტკიცონ	V,3,PL,OPT
დაიმტკიცებდნენ	V,3,PL,SBJV,FUT
დაემტკიცებინოთ	V,3,PL,SBJV,PRF
იმტკიცებდნენ	V,3,PL,SBJV,PRS
დაიმტკიცებდა	V,3,SG,COND
დაიმტკიცოს	V,3,SG,IMP
დაიმტკიცებს	V,3,SG,IND,FUT
იმტკიცებდა	V,3,SG,IND,IPFV
დაუმტკიცებია	V,3,SG,IND,PRF
იმტკიცებს	V,3,SG,IND,PRS
დაიმტკიცა	V,3,SG,IND,PST,PFV
დაემტკიცებინა	V,3,SG,IND,PST,PRF
დაიმტკიცოს	V,3,SG,OPT
დაიმტკიცებდეს	V,3,SG,SBJV,FUT
დაემტკიცებინოს	V,3,SG,SBJV,PRF
იმტკიცებდეს	V,3,SG,SBJV,PRS

დავთესავდით	V,1,PL,COND
დავთესოთ	V,1,PL,IMP
დავთესავთ	V,1,PL,IND,FUT
ვთესავდით	V,1,PL,IND,IPFV
დაგვითესია	V,1,PL,IND,PRF
ვთესავთ	V,1,PL,IND,PRS
დავთესეთ	V,1,PL,IND,PST,PFV
დაგვეთესა	V,1,PL,IND,PST,PRF
დავთესოთ	V,1,PL,OPT
დავთესავდეთ	V,1,PL,SBJV,FUT
დაგვეთესოს	V,1,PL,SBJV,PRF
ვთესავდეთ	V,1,PL,SBJV,PRS
დავთესავდი	V,1,SG,COND
დავთესავ	V,1,SG,IND,FUT
ვთესავდი	V,1,SG,IND,IPFV
დამითესია	V,1,SG,IND,PRF
ვთესავ	V,1,SG,IND,PRS
დავთესე	V,1,SG,IND,PST,PFV
დამეთესა	V,1,SG,IND,PST,PRF
დავთესო	V,1,SG,OPT
დავთესავდე	V,1,SG,SBJV,FUT
დამეთესოს	V,1,SG,SBJV,PRF
ვთესავდე	V,1,SG,SBJV,PRS
დათესავდით	V,2,PL,COND
დათესეთ	V,2,PL,IMP
დათესავთ	V,2,PL,IND,FUT
თესავდით	V,2,PL,IND,IPFV
დაგითესიათ	V,2,PL,IND,PRF
თესავთ	V,2,PL,IND,PRS
დათესეთ	V,2,PL,IND,PST,PFV
დაგეთესათ	V,2,PL,IND,PST,PRF
დათესოთ	V,2,PL,OPT
დათესავდეთ	V,2,PL,SBJV,FUT
დაგეთესოთ	V,2,PL,SBJV,PRF
თესავდეთ	V,2,PL,SBJV,PRS
დათესავდი	V,2,SG,COND
დათესე	V,2,SG,IMP
დათესავ	V,2,SG,IND,FUT
თესავდი	V,2,SG,IND,IPFV
დაგითესია	V,2,SG,IND,PRF
თესავ	V,2,SG,IND,PRS
დათესე	V,2,SG,IND,PST,PFV
დაგეთესა	V,2,SG,IND,PST,PRF
დათესო	V,2,SG,OPT
დათესავდე	V,2,SG,SBJV,FUT
დაგეთესოს	V,2,SG,SBJV,PRF
თესავდე	V,2,SG,SBJV,PRS
დათესავდნენ	V,3,PL,COND
დათესონ	V,3,PL,IMP
დათესავენ	V,3,PL,IND,FUT
თესავდნენ	V,3,PL,IND,IPFV
დაუთესიათ	V,3,PL,IND,PRF
თესავენ	V,3,PL,IND,PRS
დათესეს	V,3,PL,IND,PST,PFV
დაეთესათ	V,3,PL,IND,PST,PRF
დათესონ	V,3,PL,OPT
დათესავდნენ	V,3,PL,SBJV,FUT
დაეთესოთ	V,3,PL,SBJV,PRF
თესავდნენ	V,3,PL,SBJV,PRS
დათესავდა	V,3,SG,COND
დათესოს	V,3,SG,IMP
დათესავს	V,3,SG,IND,FUT
თესავდა	V,3,SG,IND,IPFV
დაუთესია	V,3,SG,IND,PRF
თესავს	V,3,SG,IND,PRS
დათესა	V,3,SG,IND,PST,PFV
დაეთესა	V,3,SG,IND,PST,PRF
დათესოს	V,3,SG,OPT
დათესავდეს	V,3,SG,SBJV,FUT
დაეთესოს	V,3,SG,SBJV,PRF
თესავდეს	V,3,SG,SBJV,PRS

დავასრულებდით	V,1,PL,COND
დავასრულოთ	V,1,PL,IMP
დავასრულებთ	V,1,PL,IND,FUT
ვასრულებდით	V,1,PL,IND,IPFV
დაგვისრულებია	V,1,PL,IND,PRF
ვასრულებთ	V,1,PL,IND,PRS
დავასრულეთ	V,1,PL,IND,PST,PFV
დაგვესრულებინა	V,1,PL,IND,PST,PRF
დავასრულოთ	V,1,PL,OPT
დავასრულებდეთ	V,1,PL,SBJV,FUT
დაგვესრულებინოს	V,1,PL,SBJV,PRF
ვასრულებდეთ	V,1,PL,SBJV,PRS
დავასრულებდი	V,1,SG,COND
დავასრულებ	V,1,SG,IND,FUT
ვასრულებდი	V,1,SG,IND,IPFV
დამისრულებია	V,1,SG,IND,PRF
ვასრულებ	V,1,SG,IND,PRS
დავასრულე	V,1,SG,IND,PST,PFV
დამესრულებინა	V,1,SG,IND,PST,PRF
დავასრულო	V,1,SG,OPT
დავასრულებდე	V,1,SG,SBJV,FUT
დამესრულებინოს	V,1,SG,SBJV,PRF
ვასრულებდე	V,1,SG,SBJV,PRS
დაასრულებდით	V,2,PL,COND
დაასრულეთ	V,2,PL,IMP
დაასრულებთ	V,2,PL,IND,FUT
ასრულებდით	V,2,PL,IND,IPFV
დაგისრულებიათ	V,2,PL,IND,PRF
ასრულებთ	V,2,PL,IND,PRS
დაასრულეთ	V,2,PL,IND,PST,PFV
დაგესრულებინათ	V,2,PL,IND,PST,PRF
დაასრულოთ	V,2,PL,OPT
დაასრულებდეთ	V,2,PL,SBJV,FUT
დაგესრულებინოთ	V,2,PL,SBJV,PRF
ასრულებდეთ	V,2,PL,SBJV,PRS
დაასრულებდი	V,2,SG,COND
დაასრულე	V,2,SG,IMP
დაასრულებ	V,2,SG,IND,FUT
ასრულებდი	V,2,SG,IND,IPFV
დაგისრულებია	V,2,SG,IND,PRF
ასრულებ	V,2,SG,IND,PRS
დაასრულე	V,2,SG,IND,PST,PFV
დაგესრულებინა	V,2,SG,IND,PST,PRF
დაასრულო	V,2,SG,OPT
დაასრულებდე	V,2,SG,SBJV,FUT
დაგესრულებინოს	V,2,SG,SBJV,PRF
ასრულებდე	V,2,SG,SBJV,PRS
დაასრულებდნენ	V,3,PL,COND
დაასრულონ	V,3,PL,IMP
დაასრულებენ	V,3,PL,IND,FUT
ასრულებდნენ	V,3,PL,IND,IPFV
დაუსრულებიათ	V,3,PL,IND,PRF
ასრულებენ	V,3,PL,IND,PRS
დაასრულეს	V,3,PL,IND,PST,PFV
დაესრულებინათ	V,3,PL,IND,PST,PRF
დაასრულონ	V,3,PL,OPT
დაასრულებდნენ	V,3,PL,SBJV,FUT
დაესრულებინოთ	V,3,PL,SBJV,PRF
ასრულებდნენ	V,3,PL,SBJV,PRS
დაასრულებდა	V,3,SG,COND
დაასრულოს	V,3,SG,IMP
დაასრულებს	V,3,SG,IND,FUT
ასრულებდა	V,3,SG,IND,IPFV
დაუსრულებია	V,3,SG,IND,PRF
ასრულებს	V,3,SG,IND,PRS
დაასრულა	V,3,SG,IND,PST,PFV
დაესრულებინა	V,3,SG,IND,PST,PRF
დაასრულოს	V,3,SG,OPT
დაასრულებდეს	V,3,SG,SBJV,FUT
დაესრულებინოს	V,3,SG,SBJV,PRF
ასრულებდეს	V,3,SG,SBJV,PRS

დავატრიალებდით	V,1,PL,COND
დავატრიალოთ	V,1,PL,IMP
დავატრიალებთ	V,1,PL,IND,FUT
ვატრიალებდით	V,1,PL,IND,IPFV
დაგვიტრიალებია	V,1,PL,IND,PRF
ვატრიალებთ	V,1,PL,IND,PRS
დავატრიალეთ	V,1,PL,IND,PST,PFV
დაგვეტრიალებინა	V,1,PL,IND,PST,PRF
დავატრიალოთ	V,1,PL,OPT
დავატრიალებდეთ	V,1,PL,SBJV,FUT
დაგვეტრიალებინოს	V,1,PL,SBJV,PRF
ვატრიალებდეთ	V,1,PL,SBJV,PRS
დავატრიალებდი	V,1,SG,COND
დავატრიალებ	V,1,SG,IND,FUT
ვატრიალებდი	V,1,SG,IND,IPFV
დამიტრიალებია	V,1,SG,IND,PRF
ვატრიალებ	V,1,SG,IND,PRS
დავატრიალე	V,1,SG,IND,PST,PFV
დამეტრიალებინა	V,1,SG,IND,PST,PRF
დავატრიალო	V,1,SG,OPT
დავატრიალებდე	V,1,SG,SBJV,FUT
დამეტრიალებინოს	V,1,SG,SBJV,PRF
ვატრიალებდე	V,1,SG,SBJV,PRS
დაატრიალებდით	V,2,PL,COND
დაატრიალეთ	V,2,PL,IMP
დაატრიალებთ	V,2,PL,IND,FUT
ატრიალებდით	V,2,PL,IND,IPFV
დაგიტრიალებიათ	V,2,PL,IND,PRF
ატრიალებთ	V,2,PL,IND,PRS
დაატრიალეთ	V,2,PL,IND,PST,PFV
დაგეტრიალებინათ	V,2,PL,IND,PST,PRF
დაატრიალოთ	V,2,PL,OPT
დაატრიალებდეთ	V,2,PL,SBJV,FUT
დაგეტრიალებინოთ	V,2,PL,SBJV,PRF
ატრიალებდეთ	V,2,PL,SBJV,PRS
დაატრიალებდი	V,2,SG,COND
დაატრიალე	V,2,SG,IMP
დაატრიალებ	V,2,SG,IND,FUT
ატრიალებდი	V,2,SG,IND,IPFV
დაგიტრიალებია	V,2,SG,IND,PRF
ატრიალებ	V,2,SG,IND,PRS
დაატრიალე	V,2,SG,IND,PST,PFV
დაგეტრიალებინა	V,2,SG,IND,PST,PRF
დაატრიალო	V,2,SG,OPT
დაატრიალებდე	V,2,SG,SBJV,FUT
დაგეტრიალებინოს	V,2,SG,SBJV,PRF
ატრიალებდე	V,2,SG,SBJV,PRS
დაატრიალებდნენ	V,3,PL,COND
დაატრიალონ	V,3,PL,IMP
დაატრიალებენ	V,3,PL,IND,FUT
ატრიალებდნენ	V,3,PL,IND,IPFV
დაუტრიალებიათ	V,3,PL,IND,PRF
ატრიალებენ	V,3,PL,IND,PRS
დაატრიალეს	V,3,PL,IND,PST,PFV
დაეტრიალებინათ	V,3,PL,IND,PST,PRF
დაატრიალონ	V,3,PL,OPT
დაატრიალებდნენ	V,3,PL,SBJV,FUT
დაეტრიალებინოთ	V,3,PL,SBJV,PRF
ატრიალებდნენ	V,3,PL,SBJV,PRS
დაატრიალებდა	V,3,SG,COND
დაატრიალოს	V,3,SG,IMP
დაატრიალებს	V,3,SG,IND,FUT
ატრიალებდა	V,3,SG,IND,IPFV
დაუტრიალებია	V,3,SG,IND,PRF
ატრიალებს	V,3,SG,IND,PRS
დაატრიალა	V,3,SG,IND,PST,PFV
დაეტრიალებინა	V,3,SG,IND,PST,PRF
დაატრიალოს	V,3,SG,OPT
დაატრიალებდეს	V,3,SG,SBJV,FUT
დაეტრიალებინოს	V,3,SG,SBJV,PRF
ატრიალებდეს	V,3,SG,SBJV,PRS

დავადგენდით	V,1,PL,COND
დავადგინოთ	V,1,PL,IMP
დავადგენთ	V,1,PL,IND,FUT
ვადგენდით	V,1,PL,IND,IPFV
დაგვიდგენია	V,1,PL,IND,PRF
ვადგენთ	V,1,PL,IND,PRS
დავადგინეთ	V,1,PL,IND,PST,PFV
დაგვედგინა	V,1,PL,IND,PST,PRF
დავადგინოთ	V,1,PL,OPT
დავადგენდეთ	V,1,PL,SBJV,FUT
დაგვედგინოს	V,1,PL,SBJV,PRF
ვადგენდეთ	V,1,PL,SBJV,PRS
დავადგენდი	V,1,SG,COND
დავადგენ	V,1,SG,IND,FUT
ვადგენდი	V,1,SG,IND,IPFV
დამიდგენია	V,1,SG,IND,PRF
ვადგენ	V,1,SG,IND,PRS
დავადგინე	V,1,SG,IND,PST,PFV
დამედგინა	V,1,SG,IND,PST,PRF
დავადგინო	V,1,SG,OPT
დავადგენდე	V,1,SG,SBJV,FUT
დამედგინოს	V,1,SG,SBJV,PRF
ვადგენდე	V,1,SG,SBJV,PRS
დაადგენდით	V,2,PL,COND
დაადგინეთ	V,2,PL,IMP
დაადგენთ	V,2,PL,IND,FUT
ადგენდით	V,2,PL,IND,IPFV
დაგიდგენიათ	V,2,PL,IND,PRF
ადგენთ	V,2,PL,IND,PRS
დაადგინეთ	V,2,PL,IND,PST,PFV
დაგედგინათ	V,2,PL,IND,PST,PRF
დაადგინოთ	V,2,PL,OPT
დაადგენდეთ	V,2,PL,SBJV,FUT
დაგედგინოთ	V,2,PL,SBJV,PRF
ადგენდეთ	V,2,PL,SBJV,PRS
დაადგენდი	V,2,SG,COND
დაადგინე	V,2,SG,IMP
დაადგენ	V,2,SG,IND,FUT
ადგენდი	V,2,SG,IND,IPFV
დაგიდგენია	V,2,SG,IND,PRF
ადგენ	V,2,SG,IND,PRS
დაადგინე	V,2,SG,IND,PST,PFV
დაგედგინა	V,2,SG,IND,PST,PRF
დაადგინო	V,2,SG,OPT
დაადგენდე	V,2,SG,SBJV,FUT
დაგედგინოს	V,2,SG,SBJV,PRF
ადგენდე	V,2,SG,SBJV,PRS
დაადგენდნენ	V,3,PL,COND
დაადგინონ	V,3,PL,IMP
დაადგენენ	V,3,PL,IND,FUT
ადგენდნენ	V,3,PL,IND,IPFV
დაუდგენიათ	V,3,PL,IND,PRF
ადგენენ	V,3,PL,IND,PRS
დაადგინეს	V,3,PL,IND,PST,PFV
დაედგინათ	V,3,PL,IND,PST,PRF
დაადგინონ	V,3,PL,OPT
დაადგენდნენ	V,3,PL,SBJV,FUT
დაედგინოთ	V,3,PL,SBJV,PRF
ადგენდნენ	V,3,PL,SBJV,PRS
დაადგენდა	V,3,SG,COND
დაადგინოს	V,3,SG,IMP
დაადგენს	V,3,SG,IND,FUT
ადგენდა	V,3,SG,IND,IPFV
დაუდგენია	V,3,SG,IND,PRF
ადგენს	V,3,SG,IND,PRS
დაადგინა	V,3,SG,IND,PST,PFV
დაედგინა	V,3,SG,IND,PST,PRF
დაადგინოს	V,3,SG,OPT
დაადგენდეს	V,3,SG,SBJV,FUT
დაედგინოს	V,3,SG,SBJV,PRF
ადგენდეს	V,3,SG,SBJV,PRS

გავახურებდით	V,1,PL,COND
გავახუროთ	V,1,PL,IMP
გავახურებთ	V,1,PL,IND,FUT
ვახურებდით	V,1,PL,IND,IPFV
გაგვიხურია	V,1,PL,IND,PRF
ვახურებთ	V,1,PL,IND,PRS
გავახურეთ	V,1,PL,IND,PST,PFV
გაგვეხურებინა	V,1,PL,IND,PST,PRF
გავახუროთ	V,1,PL,OPT
გავახურებდეთ	V,1,PL,SBJV,FUT
გაგვეხურებინოს	V,1,PL,SBJV,PRF
ვახურებდეთ	V,1,PL,SBJV,PRS
გავახურებდი	V,1,SG,COND
გავახურებ	V,1,SG,IND,FUT
ვახურებდი	V,1,SG,IND,IPFV
გამიხურია	V,1,SG,IND,PRF
ვახურებ	V,1,SG,IND,PRS
გავახურე	V,1,SG,IND,PST,PFV
გამეხურებინა	V,1,SG,IND,PST,PRF
გავახურო	V,1,SG,OPT
გავახურებდე	V,1,SG,SBJV,FUT
გამეხურებინოს	V,1,SG,SBJV,PRF
ვახურებდე	V,1,SG,SBJV,PRS
გაახურებდით	V,2,PL,COND
გაახურეთ	V,2,PL,IMP
გაახურებთ	V,2,PL,IND,FUT
ახურებდით	V,2,PL,IND,IPFV
გაგიხურიათ	V,2,PL,IND,PRF
ახურებთ	V,2,PL,IND,PRS
გაახურეთ	V,2,PL,IND,PST,PFV
გაგეხურებინათ	V,2,PL,IND,PST,PRF
გაახუროთ	V,2,PL,OPT
გაახურებდეთ	V,2,PL,SBJV,FUT
გაგეხურებინოთ	V,2,PL,SBJV,PRF
ახურებდეთ	V,2,PL,SBJV,PRS
გაახურებდი	V,2,SG,COND
გაახურე	V,2,SG,IMP
გაახურებ	V,2,SG,IND,FUT
ახურებდი	V,2,SG,IND,IPFV
გაგიხურია	V,2,SG,IND,PRF
ახურებ	V,2,SG,IND,PRS
გაახურე	V,2,SG,IND,PST,PFV
გაგეხურებინა	V,2,SG,IND,PST,PRF
გაახურო	V,2,SG,OPT
გაახურებდე	V,2,SG,SBJV,FUT
გაგეხურებინოს	V,2,SG,SBJV,PRF
ახურებდე	V,2,SG,SBJV,PRS
გაახურებდნენ	V,3,PL,COND
გაახურონ	V,3,PL,IMP
გაახურებენ	V,3,PL,IND,FUT
ახურებდნენ	V,3,PL,IND,IPFV
გაუხურიათ	V,3,PL,IND,PRF
ახურებენ	V,3,PL,IND,PRS
გაახურეს	V,3,PL,IND,PST,PFV
გაეხურებინათ	V,3,PL,IND,PST,PRF
გაახურონ	V,3,PL,OPT
გაახურებდნენ	V,3,PL,SBJV,FUT
გაეხურებინოთ	V,3,PL,SBJV,PRF
ახურებდნენ	V,3,PL,SBJV,PRS
გაახურებდა	V,3,SG,COND
გაახუროს	V,3,SG,IMP
გაახურებს	V,3,SG,IND,FUT
ახურებდა	V,3,SG,IND,IPFV
გაუხურია	V,3,SG,IND,PRF
ახურებს	V,3,SG,IND,PRS
გაახურა	V,3,SG,IND,PST,PFV
გაეხურებინა	V,3,SG,IND,PST,PRF
გაახუროს	V,3,SG,OPT
გაახურებდეს	V,3,SG,SBJV,FUT
გაეხურებინოს	V,3,SG,SBJV,PRF
ახურებდეს	V,3,SG,SBJV,PRS

აღმოვაჩენდით	V,1,PL,COND
აღმოვაჩინოთ	V,1,PL,IMP
აღმოვაჩენთ	V,1,PL,IND,FUT
აღმოგვიჩენია	V,1,PL,IND,PRF
აღმოვაჩინეთ	V,1,PL,IND,PST,PFV
აღმოგვეჩინა	V,1,PL,IND,PST,PRF
აღმოვაჩინოთ	V,1,PL,OPT
აღმოვაჩენდეთ	V,1,PL,SBJV,FUT
აღმოგვეჩინოს	V,1,PL,SBJV,PRF
აღმოვაჩენდი	V,1,SG,COND
აღმოვაჩენ	V,1,SG,IND,FUT
აღმომიჩენია	V,1,SG,IND,PRF
აღმოვაჩინე	V,1,SG,IND,PST,PFV
აღმომეჩინა	V,1,SG,IND,PST,PRF
აღმოვაჩინო	V,1,SG,OPT
აღმოვაჩენდე	V,1,SG,SBJV,FUT
აღმომეჩინოს	V,1,SG,SBJV,PRF
აღმოაჩენდით	V,2,PL,COND
აღმოაჩინეთ	V,2,PL,IMP
აღმოაჩენთ	V,2,PL,IND,FUT
აღმოგიჩენიათ	V,2,PL,IND,PRF
აღმოაჩინეთ	V,2,PL,IND,PST,PFV
აღმოგეჩინათ	V,2,PL,IND,PST,PRF
აღმოაჩინოთ	V,2,PL,OPT
აღმოაჩენდეთ	V,2,PL,SBJV,FUT
აღმოგეჩინოთ	V,2,PL,SBJV,PRF
აღმოაჩენდი	V,2,SG,COND
აღმოაჩინე	V,2,SG,IMP
აღმოაჩენ	V,2,SG,IND,FUT
აღმოგიჩენია	V,2,SG,IND,PRF
აღმოაჩინე	V,2,SG,IND,PST,PFV
აღმოგეჩინა	V,2,SG,IND,PST,PRF
აღმოაჩინო	V,2,SG,OPT
აღმოაჩენდე	V,2,SG,SBJV,FUT
აღმოგეჩინოს	V,2,SG,SBJV,PRF
აღმოაჩენდნენ	V,3,PL,COND
აღმოაჩინონ	V,3,PL,IMP
აღმოაჩენენ	V,3,PL,IND,FUT
აღმოუჩენიათ	V,3,PL,IND,PRF
აღმოაჩინეს	V,3,PL,IND,PST,PFV
აღმოეჩინათ	V,3,PL,IND,PST,PRF
აღმოაჩინონ	V,3,PL,OPT
აღმოაჩენდნენ	V,3,PL,SBJV,FUT
აღმოეჩინოთ	V,3,PL,SBJV,PRF
აღმოაჩენდა	V,3,SG,COND
აღმოაჩინოს	V,3,SG,IMP
აღმოაჩენს	V,3,SG,IND,FUT
აღმოუჩენია	V,3,SG,IND,PRF
აღმოაჩინა	V,3,SG,IND,PST,PFV
აღმოეჩინა	V,3,SG,IND,PST,PRF
აღმოაჩინოს	V,3,SG,OPT
აღმოაჩენდეს	V,3,SG,SBJV,FUT
აღმოეჩინოს	V,3,SG,SBJV,PRF

დავახველებდით	V,1,PL,COND
დავახველოთ	V,1,PL,IMP
დავახველებთ	V,1,PL,IND,FUT
ვახველებდით	V,1,PL,IND,IPFV
დაგვიხველებია	V,1,PL,IND,PRF
ვახველებთ	V,1,PL,IND,PRS
დავახველეთ	V,1,PL,IND,PST,PFV
დაგვეხველებინა	V,1,PL,IND,PST,PRF
დავახველოთ	V,1,PL,OPT
დავახველებდეთ	V,1,PL,SBJV,FUT
დაგვეხველებინოს	V,1,PL,SBJV,PRF
ვახველებდეთ	V,1,PL,SBJV,PRS
დავახველებდი	V,1,SG,COND
დავახველებ	V,1,SG,IND,FUT
ვახველებდი	V,1,SG,IND,IPFV
დამიხველებია	V,1,SG,IND,PRF
ვახველებ	V,1,SG,IND,PRS
დავახველე	V,1,SG,IND,PST,PFV
დამეხველებინა	V,1,SG,IND,PST,PRF
დავახველო	V,1,SG,OPT
დავახველებდე	V,1,SG,SBJV,FUT
დამეხველებინოს	V,1,SG,SBJV,PRF
ვახველებდე	V,1,SG,SBJV,PRS
დაახველებდით	V,2,PL,COND
დაახველეთ	V,2,PL,IMP
დაახველებთ	V,2,PL,IND,FUT
ახველებდით	V,2,PL,IND,IPFV
დაგიხველებიათ	V,2,PL,IND,PRF
ახველებთ	V,2,PL,IND,PRS
დაახველეთ	V,2,PL,IND,PST,PFV
დაგეხველებინათ	V,2,PL,IND,PST,PRF
დაახველოთ	V,2,PL,OPT
დაახველებდეთ	V,2,PL,SBJV,FUT
დაგეხველებინოთ	V,2,PL,SBJV,PRF
ახველებდეთ	V,2,PL,SBJV,PRS
დაახველებდი	V,2,SG,COND
დაახველე	V,2,SG,IMP
დაახველებ	V,2,SG,IND,FUT
ახველებდი	V,2,SG,IND,IPFV
დაგიხველებია	V,2,SG,IND,PRF
ახველებ	V,2,SG,IND,PRS
დაახველე	V,2,SG,IND,PST,PFV
დაგეხველებინა	V,2,SG,IND,PST,PRF
დაახველო	V,2,SG,OPT
დაახველებდე	V,2,SG,SBJV,FUT
დაგეხველებინოს	V,2,SG,SBJV,PRF
ახველებდე	V,2,SG,SBJV,PRS
დაახველებდნენ	V,3,PL,COND
დაახველონ	V,3,PL,IMP
დაახველებენ	V,3,PL,IND,FUT
ახველებდნენ	V,3,PL,IND,IPFV
დაუხველებიათ	V,3,PL,IND,PRF
ახველებენ	V,3,PL,IND,PRS
დაახველეს	V,3,PL,IND,PST,PFV
დაეხველებინათ	V,3,PL,IND,PST,PRF
დაახველონ	V,3,PL,OPT
დაახველებდნენ	V,3,PL,SBJV,FUT
დაეხველებინოთ	V,3,PL,SBJV,PRF
ახველებდნენ	V,3,PL,SBJV,PRS
დაახველებდა	V,3,SG,COND
დაახველოს	V,3,SG,IMP
დაახველებს	V,3,SG,IND,FUT
ახველებდა	V,3,SG,IND,IPFV
დაუხველებია	V,3,SG,IND,PRF
ახველებს	V,3,SG,IND,PRS
დაახველა	V,3,SG,IND,PST,PFV
დაეხველებინა	V,3,SG,IND,PST,PRF
დაახველოს	V,3,SG,OPT
დაახველებდეს	V,3,SG,SBJV,FUT
დაეხველებინოს	V,3,SG,SBJV,PRF
ახველებდეს	V,3,SG,SBJV,PRS

დავახველებდით	V,1,PL,COND
დავახველოთ	V,1,PL,IMP
დავახველებთ	V,1,PL,IND,FUT
ვახველებდით	V,1,PL,IND,IPFV
დაგვიხველებია	V,1,PL,IND,PRF
ვახველებთ	V,1,PL,IND,PRS
დავახველეთ	V,1,PL,IND,PST,PFV
დაგვეხველებინა	V,1,PL,IND,PST,PRF
დავახველოთ	V,1,PL,OPT
დავახველებდეთ	V,1,PL,SBJV,FUT
დაგვეხველებინოს	V,1,PL,SBJV,PRF
ვახველებდეთ	V,1,PL,SBJV,PRS
დავახველებდი	V,1,SG,COND
დავახველებ	V,1,SG,IND,FUT
ვახველებდი	V,1,SG,IND,IPFV
დამიხველებია	V,1,SG,IND,PRF
ვახველებ	V,1,SG,IND,PRS
დავახველე	V,1,SG,IND,PST,PFV
დამეხველებინა	V,1,SG,IND,PST,PRF
დავახველო	V,1,SG,OPT
დავახველებდე	V,1,SG,SBJV,FUT
დამეხველებინოს	V,1,SG,SBJV,PRF
ვახველებდე	V,1,SG,SBJV,PRS
დაახველებდით	V,2,PL,COND
დაახველეთ	V,2,PL,IMP
დაახველებთ	V,2,PL,IND,FUT
ახველებდით	V,2,PL,IND,IPFV
დაგიხველებიათ	V,2,PL,IND,PRF
ახველებთ	V,2,PL,IND,PRS
დაახველეთ	V,2,PL,IND,PST,PFV
დაგეხველებინათ	V,2,PL,IND,PST,PRF
დაახველოთ	V,2,PL,OPT
დაახველებდეთ	V,2,PL,SBJV,FUT
დაგეხველებინოთ	V,2,PL,SBJV,PRF
ახველებდეთ	V,2,PL,SBJV,PRS
დაახველებდი	V,2,SG,COND
დაახველე	V,2,SG,IMP
დაახველებ	V,2,SG,IND,FUT
ახველებდი	V,2,SG,IND,IPFV
დაგიხველებია	V,2,SG,IND,PRF
ახველებ	V,2,SG,IND,PRS
დაახველე	V,2,SG,IND,PST,PFV
დაგეხველებინა	V,2,SG,IND,PST,PRF
დაახველო	V,2,SG,OPT
დაახველებდე	V,2,SG,SBJV,FUT
დაგეხველებინოს	V,2,SG,SBJV,PRF
ახველებდე	V,2,SG,SBJV,PRS
დაახველებდნენ	V,3,PL,COND
დაახველონ	V,3,PL,IMP
დაახველებენ	V,3,PL,IND,FUT
ახველებდნენ	V,3,PL,IND,IPFV
დაუხველებიათ	V,3,PL,IND,PRF
ახველებენ	V,3,PL,IND,PRS
დაახველეს	V,3,PL,IND,PST,PFV
დაეხველებინათ	V,3,PL,IND,PST,PRF
დაახველონ	V,3,PL,OPT
დაახველებდნენ	V,3,PL,SBJV,FUT
დაეხველებინოთ	V,3,PL,SBJV,PRF
ახველებდნენ	V,3,PL,SBJV,PRS
დაახველებდა	V,3,SG,COND
დაახველოს	V,3,SG,IMP
დაახველებს	V,3,SG,IND,FUT
ახველებდა	V,3,SG,IND,IPFV
დაუხველებია	V,3,SG,IND,PRF
ახველებს	V,3,SG,IND,PRS
დაახველა	V,3,SG,IND,PST,PFV
დაეხველებინა	V,3,SG,IND,PST,PRF
დაახველოს	V,3,SG,OPT
დაახველებდეს	V,3,SG,SBJV,FUT
დაეხველებინოს	V,3,SG,SBJV,PRF
ახველებდეს	V,3,SG,SBJV,PRS

დავაბრუნებდით	V,1,PL,COND
დავაბრუნოთ	V,1,PL,IMP
დავაბრუნებთ	V,1,PL,IND,FUT
ვაბრუნებდით	V,1,PL,IND,IPFV
დაგვიბრუნებია	V,1,PL,IND,PRF
ვაბრუნებთ	V,1,PL,IND,PRS
დავაბრუნეთ	V,1,PL,IND,PST,PFV
დაგვებრუნებინა	V,1,PL,IND,PST,PRF
დავაბრუნოთ	V,1,PL,OPT
დავაბრუნებდეთ	V,1,PL,SBJV,FUT
დაგვებრუნებინოს	V,1,PL,SBJV,PRF
ვაბრუნებდეთ	V,1,PL,SBJV,PRS
დავაბრუნებდი	V,1,SG,COND
დავაბრუნებ	V,1,SG,IND,FUT
ვაბრუნებდი	V,1,SG,IND,IPFV
დამიბრუნებია	V,1,SG,IND,PRF
ვაბრუნებ	V,1,SG,IND,PRS
დავაბრუნე	V,1,SG,IND,PST,PFV
დამებრუნებინა	V,1,SG,IND,PST,PRF
დავაბრუნო	V,1,SG,OPT
დავაბრუნებდე	V,1,SG,SBJV,FUT
დამებრუნებინოს	V,1,SG,SBJV,PRF
ვაბრუნებდე	V,1,SG,SBJV,PRS
დააბრუნებდით	V,2,PL,COND
დააბრუნეთ	V,2,PL,IMP
დააბრუნებთ	V,2,PL,IND,FUT
აბრუნებდით	V,2,PL,IND,IPFV
დაგიბრუნებიათ	V,2,PL,IND,PRF
აბრუნებთ	V,2,PL,IND,PRS
დააბრუნეთ	V,2,PL,IND,PST,PFV
დაგებრუნებინათ	V,2,PL,IND,PST,PRF
დააბრუნოთ	V,2,PL,OPT
დააბრუნებდეთ	V,2,PL,SBJV,FUT
დაგებრუნებინოთ	V,2,PL,SBJV,PRF
აბრუნებდეთ	V,2,PL,SBJV,PRS
დააბრუნებდი	V,2,SG,COND
დააბრუნე	V,2,SG,IMP
დააბრუნებ	V,2,SG,IND,FUT
აბრუნებდი	V,2,SG,IND,IPFV
დაგიბრუნებია	V,2,SG,IND,PRF
აბრუნებ	V,2,SG,IND,PRS
დააბრუნე	V,2,SG,IND,PST,PFV
დაგებრუნებინა	V,2,SG,IND,PST,PRF
დააბრუნო	V,2,SG,OPT
დააბრუნებდე	V,2,SG,SBJV,FUT
დაგებრუნებინოს	V,2,SG,SBJV,PRF
აბრუნებდე	V,2,SG,SBJV,PRS
დააბრუნებდნენ	V,3,PL,COND
დააბრუნონ	V,3,PL,IMP
დააბრუნებენ	V,3,PL,IND,FUT
აბრუნებდნენ	V,3,PL,IND,IPFV
დაუბრუნებიათ	V,3,PL,IND,PRF
აბრუნებენ	V,3,PL,IND,PRS
დააბრუნეს	V,3,PL,IND,PST,PFV
დაებრუნებინათ	V,3,PL,IND,PST,PRF
დააბრუნონ	V,3,PL,OPT
დააბრუნებდნენ	V,3,PL,SBJV,FUT
დაებრუნებინოთ	V,3,PL,SBJV,PRF
აბრუნებდნენ	V,3,PL,SBJV,PRS
დააბრუნებდა	V,3,SG,COND
დააბრუნოს	V,3,SG,IMP
დააბრუნებს	V,3,SG,IND,FUT
აბრუნებდა	V,3,SG,IND,IPFV
დაუბრუნებია	V,3,SG,IND,PRF
აბრუნებს	V,3,SG,IND,PRS
დააბრუნა	V,3,SG,IND,PST,PFV
დაებრუნებინა	V,3,SG,IND,PST,PRF
დააბრუნოს	V,3,SG,OPT
დააბრუნებდეს	V,3,SG,SBJV,FUT
დაებრუნებინოს	V,3,SG,SBJV,PRF
აბრუნებდეს	V,3,SG,SBJV,PRS

დავხატავდით	V,1,PL,COND
დავხატოთ	V,1,PL,IMP
დავხატავთ	V,1,PL,IND,FUT
ვხატავდით	V,1,PL,IND,IPFV
დაგვიხატია	V,1,PL,IND,PRF
ვხატავთ	V,1,PL,IND,PRS
დავხატეთ	V,1,PL,IND,PST,PFV
დაგვეხატა	V,1,PL,IND,PST,PRF
დავხატოთ	V,1,PL,OPT
დავხატავდეთ	V,1,PL,SBJV,FUT
დაგვეხატოს	V,1,PL,SBJV,PRF
ვხატავდეთ	V,1,PL,SBJV,PRS
დავხატავდი	V,1,SG,COND
დავხატავ	V,1,SG,IND,FUT
ვხატავდი	V,1,SG,IND,IPFV
დამიხატია	V,1,SG,IND,PRF
ვხატავ	V,1,SG,IND,PRS
დავხატე	V,1,SG,IND,PST,PFV
დამეხატა	V,1,SG,IND,PST,PRF
დავხატო	V,1,SG,OPT
დავხატავდე	V,1,SG,SBJV,FUT
დამეხატოს	V,1,SG,SBJV,PRF
ვხატავდე	V,1,SG,SBJV,PRS
დახატავდით	V,2,PL,COND
დახატეთ	V,2,PL,IMP
დახატავთ	V,2,PL,IND,FUT
ხატავდით	V,2,PL,IND,IPFV
დაგიხატიათ	V,2,PL,IND,PRF
ხატავთ	V,2,PL,IND,PRS
დახატეთ	V,2,PL,IND,PST,PFV
დაგეხატათ	V,2,PL,IND,PST,PRF
დახატოთ	V,2,PL,OPT
დახატავდეთ	V,2,PL,SBJV,FUT
დაგეხატოთ	V,2,PL,SBJV,PRF
ხატავდეთ	V,2,PL,SBJV,PRS
დახატავდი	V,2,SG,COND
დახატე	V,2,SG,IMP
დახატავ	V,2,SG,IND,FUT
ხატავდი	V,2,SG,IND,IPFV
დაგიხატია	V,2,SG,IND,PRF
ხატავ	V,2,SG,IND,PRS
დახატე	V,2,SG,IND,PST,PFV
დაგეხატა	V,2,SG,IND,PST,PRF
დახატო	V,2,SG,OPT
დახატავდე	V,2,SG,SBJV,FUT
დაგეხატოს	V,2,SG,SBJV,PRF
ხატავდე	V,2,SG,SBJV,PRS
დახატავდნენ	V,3,PL,COND
დახატონ	V,3,PL,IMP
დახატავენ	V,3,PL,IND,FUT
ხატავდნენ	V,3,PL,IND,IPFV
დაუხატიათ	V,3,PL,IND,PRF
ხატავენ	V,3,PL,IND,PRS
დახატეს	V,3,PL,IND,PST,PFV
დაეხატათ	V,3,PL,IND,PST,PRF
დახატონ	V,3,PL,OPT
დახატავდნენ	V,3,PL,SBJV,FUT
დაეხატოთ	V,3,PL,SBJV,PRF
ხატავდნენ	V,3,PL,SBJV,PRS
დახატავდა	V,3,SG,COND
დახატოს	V,3,SG,IMP
დახატავს	V,3,SG,IND,FUT
ხატავდა	V,3,SG,IND,IPFV
დაუხატია	V,3,SG,IND,PRF
ხატავს	V,3,SG,IND,PRS
დახატა	V,3,SG,IND,PST,PFV
დაეხატა	V,3,SG,IND,PST,PRF
დახატოს	V,3,SG,OPT
დახატავდეს	V,3,SG,SBJV,FUT
დაეხატოს	V,3,SG,SBJV,PRF
ხატავდეს	V,3,SG,SBJV,PRS

დავაპირებდით	V,1,PL,COND
დავაპიროთ	V,1,PL,IMP
დავაპირებთ	V,1,PL,IND,FUT
ვაპირებდით	V,1,PL,IND,IPFV
დაგვიპირებია	V,1,PL,IND,PRF
ვაპირებთ	V,1,PL,IND,PRS
დავაპირეთ	V,1,PL,IND,PST,PFV
დაგვეპირებინა	V,1,PL,IND,PST,PRF
დავაპიროთ	V,1,PL,OPT
დავაპირებდეთ	V,1,PL,SBJV,FUT
დაგვეპირებინოს	V,1,PL,SBJV,PRF
ვაპირებდეთ	V,1,PL,SBJV,PRS
დავაპირებდი	V,1,SG,COND
დავაპირებ	V,1,SG,IND,FUT
ვაპირებდი	V,1,SG,IND,IPFV
დამიპირებია	V,1,SG,IND,PRF
ვაპირებ	V,1,SG,IND,PRS
დავაპირე	V,1,SG,IND,PST,PFV
დამეპირებინა	V,1,SG,IND,PST,PRF
დავაპირო	V,1,SG,OPT
დავაპირებდე	V,1,SG,SBJV,FUT
დამეპირებინოს	V,1,SG,SBJV,PRF
ვაპირებდე	V,1,SG,SBJV,PRS
დააპირებდით	V,2,PL,COND
დააპირეთ	V,2,PL,IMP
დააპირებთ	V,2,PL,IND,FUT
აპირებდით	V,2,PL,IND,IPFV
დაგიპირებიათ	V,2,PL,IND,PRF
აპირებთ	V,2,PL,IND,PRS
დააპირეთ	V,2,PL,IND,PST,PFV
დაგეპირებინათ	V,2,PL,IND,PST,PRF
დააპიროთ	V,2,PL,OPT
დააპირებდეთ	V,2,PL,SBJV,FUT
დაგეპირებინოთ	V,2,PL,SBJV,PRF
აპირებდეთ	V,2,PL,SBJV,PRS
დააპირებდი	V,2,SG,COND
დააპირე	V,2,SG,IMP
დააპირებ	V,2,SG,IND,FUT
აპირებდი	V,2,SG,IND,IPFV
დაგიპირებია	V,2,SG,IND,PRF
აპირებ	V,2,SG,IND,PRS
დააპირე	V,2,SG,IND,PST,PFV
დაგეპირებინა	V,2,SG,IND,PST,PRF
დააპირო	V,2,SG,OPT
დააპირებდე	V,2,SG,SBJV,FUT
დაგეპირებინოს	V,2,SG,SBJV,PRF
აპირებდე	V,2,SG,SBJV,PRS
დააპირებდნენ	V,3,PL,COND
დააპირონ	V,3,PL,IMP
დააპირებენ	V,3,PL,IND,FUT
აპირებდნენ	V,3,PL,IND,IPFV
დაუპირებიათ	V,3,PL,IND,PRF
აპირებენ	V,3,PL,IND,PRS
დააპირეს	V,3,PL,IND,PST,PFV
დაეპირებინათ	V,3,PL,IND,PST,PRF
დააპირონ	V,3,PL,OPT
დააპირებდნენ	V,3,PL,SBJV,FUT
დაეპირებინოთ	V,3,PL,SBJV,PRF
აპირებდნენ	V,3,PL,SBJV,PRS
დააპირებდა	V,3,SG,COND
დააპიროს	V,3,SG,IMP
დააპირებს	V,3,SG,IND,FUT
აპირებდა	V,3,SG,IND,IPFV
დაუპირებია	V,3,SG,IND,PRF
აპირებს	V,3,SG,IND,PRS
დააპირა	V,3,SG,IND,PST,PFV
დაეპირებინა	V,3,SG,IND,PST,PRF
დააპიროს	V,3,SG,OPT
დააპირებდეს	V,3,SG,SBJV,FUT
დაეპირებინოს	V,3,SG,SBJV,PRF
აპირებდეს	V,3,SG,SBJV,PRS

გავფენდით	V,1,PL,COND
გავფინოთ	V,1,PL,IMP
გავფენთ	V,1,PL,IND,FUT
ვფენდით	V,1,PL,IND,IPFV
გაგვიფენია	V,1,PL,IND,PRF
ვფენთ	V,1,PL,IND,PRS
გავფინეთ	V,1,PL,IND,PST,PFV
გაგვეფინა	V,1,PL,IND,PST,PRF
გავფინოთ	V,1,PL,OPT
გავფენდეთ	V,1,PL,SBJV,FUT
გაგვეფინოს	V,1,PL,SBJV,PRF
ვფენდეთ	V,1,PL,SBJV,PRS
გავფენდი	V,1,SG,COND
გავფენ	V,1,SG,IND,FUT
ვფენდი	V,1,SG,IND,IPFV
გამიფენია	V,1,SG,IND,PRF
ვფენ	V,1,SG,IND,PRS
გავფინე	V,1,SG,IND,PST,PFV
გამეფინა	V,1,SG,IND,PST,PRF
გავფინო	V,1,SG,OPT
გავფენდე	V,1,SG,SBJV,FUT
გამეფინოს	V,1,SG,SBJV,PRF
ვფენდე	V,1,SG,SBJV,PRS
გაფენდით	V,2,PL,COND
გაფინეთ	V,2,PL,IMP
გაფენთ	V,2,PL,IND,FUT
ფენდით	V,2,PL,IND,IPFV
გაგიფენიათ	V,2,PL,IND,PRF
ფენთ	V,2,PL,IND,PRS
გაფინეთ	V,2,PL,IND,PST,PFV
გაგეფინათ	V,2,PL,IND,PST,PRF
გაფინოთ	V,2,PL,OPT
გაფენდეთ	V,2,PL,SBJV,FUT
გაგეფინოთ	V,2,PL,SBJV,PRF
ფენდეთ	V,2,PL,SBJV,PRS
გაფენდი	V,2,SG,COND
გაფინე	V,2,SG,IMP
გაფენ	V,2,SG,IND,FUT
ფენდი	V,2,SG,IND,IPFV
გაგიფენია	V,2,SG,IND,PRF
ფენ	V,2,SG,IND,PRS
გაფინე	V,2,SG,IND,PST,PFV
გაგეფინა	V,2,SG,IND,PST,PRF
გაფინო	V,2,SG,OPT
გაფენდე	V,2,SG,SBJV,FUT
გაგეფინოს	V,2,SG,SBJV,PRF
ფენდე	V,2,SG,SBJV,PRS
გაფენდნენ	V,3,PL,COND
გაფინონ	V,3,PL,IMP
გაფენენ	V,3,PL,IND,FUT
ფენდნენ	V,3,PL,IND,IPFV
გაუფენიათ	V,3,PL,IND,PRF
ფენენ	V,3,PL,IND,PRS
გაფინეს	V,3,PL,IND,PST,PFV
გაეფინათ	V,3,PL,IND,PST,PRF
გაფინონ	V,3,PL,OPT
გაფენდნენ	V,3,PL,SBJV,FUT
გაეფინოთ	V,3,PL,SBJV,PRF
ფენდნენ	V,3,PL,SBJV,PRS
გაფენდა	V,3,SG,COND
გაფინოს	V,3,SG,IMP
გაფენს	V,3,SG,IND,FUT
ფენდა	V,3,SG,IND,IPFV
გაუფენია	V,3,SG,IND,PRF
ფენს	V,3,SG,IND,PRS
გაფინა	V,3,SG,IND,PST,PFV
გაეფინა	V,3,SG,IND,PST,PRF
გაფინოს	V,3,SG,OPT
გაფენდეს	V,3,SG,SBJV,FUT
გაეფინოს	V,3,SG,SBJV,PRF
ფენდეს	V,3,SG,SBJV,PRS

გავაფუჭებდით	V,1,PL,COND
გავაფუჭოთ	V,1,PL,IMP
გავაფუჭებთ	V,1,PL,IND,FUT
ვაფუჭებდით	V,1,PL,IND,IPFV
გაგვიფუჭებია	V,1,PL,IND,PRF
ვაფუჭებთ	V,1,PL,IND,PRS
გავაფუჭეთ	V,1,PL,IND,PST,PFV
გაგვეფუჭებინა	V,1,PL,IND,PST,PRF
გავაფუჭოთ	V,1,PL,OPT
გავაფუჭებდეთ	V,1,PL,SBJV,FUT
გაგვეფუჭებინოს	V,1,PL,SBJV,PRF
ვაფუჭებდეთ	V,1,PL,SBJV,PRS
გავაფუჭებდი	V,1,SG,COND
გავაფუჭებ	V,1,SG,IND,FUT
ვაფუჭებდი	V,1,SG,IND,IPFV
გამიფუჭებია	V,1,SG,IND,PRF
ვაფუჭებ	V,1,SG,IND,PRS
გავაფუჭე	V,1,SG,IND,PST,PFV
გამეფუჭებინა	V,1,SG,IND,PST,PRF
გავაფუჭო	V,1,SG,OPT
გავაფუჭებდე	V,1,SG,SBJV,FUT
გამეფუჭებინოს	V,1,SG,SBJV,PRF
ვაფუჭებდე	V,1,SG,SBJV,PRS
გააფუჭებდით	V,2,PL,COND
გააფუჭეთ	V,2,PL,IMP
გააფუჭებთ	V,2,PL,IND,FUT
აფუჭებდით	V,2,PL,IND,IPFV
გაგიფუჭებიათ	V,2,PL,IND,PRF
აფუჭებთ	V,2,PL,IND,PRS
გააფუჭეთ	V,2,PL,IND,PST,PFV
გაგეფუჭებინათ	V,2,PL,IND,PST,PRF
გააფუჭოთ	V,2,PL,OPT
გააფუჭებდეთ	V,2,PL,SBJV,FUT
გაგეფუჭებინოთ	V,2,PL,SBJV,PRF
აფუჭებდეთ	V,2,PL,SBJV,PRS
გააფუჭებდი	V,2,SG,COND
გააფუჭე	V,2,SG,IMP
გააფუჭებ	V,2,SG,IND,FUT
აფუჭებდი	V,2,SG,IND,IPFV
გაგიფუჭებია	V,2,SG,IND,PRF
აფუჭებ	V,2,SG,IND,PRS
გააფუჭე	V,2,SG,IND,PST,PFV
გაგეფუჭებინა	V,2,SG,IND,PST,PRF
გააფუჭო	V,2,SG,OPT
გააფუჭებდე	V,2,SG,SBJV,FUT
გაგეფუჭებინოს	V,2,SG,SBJV,PRF
აფუჭებდე	V,2,SG,SBJV,PRS
გააფუჭებდნენ	V,3,PL,COND
გააფუჭონ	V,3,PL,IMP
გააფუჭებენ	V,3,PL,IND,FUT
აფუჭებდნენ	V,3,PL,IND,IPFV
გაუფუჭებიათ	V,3,PL,IND,PRF
აფუჭებენ	V,3,PL,IND,PRS
გააფუჭეს	V,3,PL,IND,PST,PFV
გაეფუჭებინათ	V,3,PL,IND,PST,PRF
გააფუჭონ	V,3,PL,OPT
გააფუჭებდნენ	V,3,PL,SBJV,FUT
გაეფუჭებინოთ	V,3,PL,SBJV,PRF
აფუჭებდნენ	V,3,PL,SBJV,PRS
გააფუჭებდა	V,3,SG,COND
გააფუჭოს	V,3,SG,IMP
გააფუჭებს	V,3,SG,IND,FUT
აფუჭებდა	V,3,SG,IND,IPFV
გაუფუჭებია	V,3,SG,IND,PRF
აფუჭებს	V,3,SG,IND,PRS
გააფუჭა	V,3,SG,IND,PST,PFV
გაეფუჭებინა	V,3,SG,IND,PST,PRF
გააფუჭოს	V,3,SG,OPT
გააფუჭებდეს	V,3,SG,SBJV,FUT
გაეფუჭებინოს	V,3,SG,SBJV,PRF
აფუჭებდეს	V,3,SG,SBJV,PRS

მივაგნებდით	V,1,PL,COND
მივაგნოთ	V,1,PL,IMP
მივაგნებთ	V,1,PL,IND,FUT
ვაგნებდით	V,1,PL,IND,IPFV
მიგვიგნია	V,1,PL,IND,PRF
ვაგნებთ	V,1,PL,IND,PRS
მივაგნეთ	V,1,PL,IND,PST,PFV
მიგვეგნებინა	V,1,PL,IND,PST,PRF
მივაგნოთ	V,1,PL,OPT
მივაგნებდეთ	V,1,PL,SBJV,FUT
მიგვეგნებინოს	V,1,PL,SBJV,PRF
ვაგნებდეთ	V,1,PL,SBJV,PRS
მივაგნებდი	V,1,SG,COND
მივაგნებ	V,1,SG,IND,FUT
ვაგნებდი	V,1,SG,IND,IPFV
მიმიგნია	V,1,SG,IND,PRF
ვაგნებ	V,1,SG,IND,PRS
მივაგნე	V,1,SG,IND,PST,PFV
მიმეგნებინა	V,1,SG,IND,PST,PRF
მივაგნო	V,1,SG,OPT
მივაგნებდე	V,1,SG,SBJV,FUT
მიმეგნებინოს	V,1,SG,SBJV,PRF
ვაგნებდე	V,1,SG,SBJV,PRS
მიაგნებდით	V,2,PL,COND
მიაგნეთ	V,2,PL,IMP
მიაგნებთ	V,2,PL,IND,FUT
აგნებდით	V,2,PL,IND,IPFV
მიგიგნიათ	V,2,PL,IND,PRF
აგნებთ	V,2,PL,IND,PRS
მიაგნეთ	V,2,PL,IND,PST,PFV
მიგეგნებინათ	V,2,PL,IND,PST,PRF
მიაგნოთ	V,2,PL,OPT
მიაგნებდეთ	V,2,PL,SBJV,FUT
მიგეგნებინოთ	V,2,PL,SBJV,PRF
აგნებდეთ	V,2,PL,SBJV,PRS
მიაგნებდი	V,2,SG,COND
მიაგნე	V,2,SG,IMP
მიაგნებ	V,2,SG,IND,FUT
აგნებდი	V,2,SG,IND,IPFV
მიგიგნია	V,2,SG,IND,PRF
აგნებ	V,2,SG,IND,PRS
მიაგნე	V,2,SG,IND,PST,PFV
მიგეგნებინა	V,2,SG,IND,PST,PRF
მიაგნო	V,2,SG,OPT
მიაგნებდე	V,2,SG,SBJV,FUT
მიგეგნებინოს	V,2,SG,SBJV,PRF
აგნებდე	V,2,SG,SBJV,PRS
მიაგნებდნენ	V,3,PL,COND
მიაგნონ	V,3,PL,IMP
მიაგნებენ	V,3,PL,IND,FUT
აგნებდნენ	V,3,PL,IND,IPFV
მიუგნიათ	V,3,PL,IND,PRF
აგნებენ	V,3,PL,IND,PRS
მიაგნეს	V,3,PL,IND,PST,PFV
მიეგნებინათ	V,3,PL,IND,PST,PRF
მიაგნონ	V,3,PL,OPT
მიაგნებდნენ	V,3,PL,SBJV,FUT
მიეგნებინოთ	V,3,PL,SBJV,PRF
აგნებდნენ	V,3,PL,SBJV,PRS
მიაგნებდა	V,3,SG,COND
მიაგნოს	V,3,SG,IMP
მიაგნებს	V,3,SG,IND,FUT
აგნებდა	V,3,SG,IND,IPFV
მიუგნია	V,3,SG,IND,PRF
აგნებს	V,3,SG,IND,PRS
მიაგნო	V,3,SG,IND,PST,PFV
მიეგნებინა	V,3,SG,IND,PST,PRF
მიაგნოს	V,3,SG,OPT
მიაგნებდეს	V,3,SG,SBJV,FUT
მიეგნებინოს	V,3,SG,SBJV,PRF
აგნებდეს	V,3,SG,SBJV,PRS

შევკერავდით	V,1,PL,COND
შევკეროთ	V,1,PL,IMP
შევკერავთ	V,1,PL,IND,FUT
ვკერავდით	V,1,PL,IND,IPFV
შეგვიკერია	V,1,PL,IND,PRF
ვკერავთ	V,1,PL,IND,PRS
შევკერეთ	V,1,PL,IND,PST,PFV
შეგვეკერა	V,1,PL,IND,PST,PRF
შევკეროთ	V,1,PL,OPT
შევკერავდეთ	V,1,PL,SBJV,FUT
შეგვეკეროს	V,1,PL,SBJV,PRF
ვკერავდეთ	V,1,PL,SBJV,PRS
შევკერავდი	V,1,SG,COND
შევკერავ	V,1,SG,IND,FUT
ვკერავდი	V,1,SG,IND,IPFV
შემიკერია	V,1,SG,IND,PRF
ვკერავ	V,1,SG,IND,PRS
შევკერე	V,1,SG,IND,PST,PFV
შემეკერა	V,1,SG,IND,PST,PRF
შევკერო	V,1,SG,OPT
შევკერავდე	V,1,SG,SBJV,FUT
შემეკეროს	V,1,SG,SBJV,PRF
ვკერავდე	V,1,SG,SBJV,PRS
შეკერავდით	V,2,PL,COND
შეკერეთ	V,2,PL,IMP
შეკერავთ	V,2,PL,IND,FUT
კერავდით	V,2,PL,IND,IPFV
შეგიკერიათ	V,2,PL,IND,PRF
კერავთ	V,2,PL,IND,PRS
შეკერეთ	V,2,PL,IND,PST,PFV
შეგეკერათ	V,2,PL,IND,PST,PRF
შეკეროთ	V,2,PL,OPT
შეკერავდეთ	V,2,PL,SBJV,FUT
შეგეკეროთ	V,2,PL,SBJV,PRF
კერავდეთ	V,2,PL,SBJV,PRS
შეკერავდი	V,2,SG,COND
შეკერე	V,2,SG,IMP
შეკერავ	V,2,SG,IND,FUT
კერავდი	V,2,SG,IND,IPFV
შეგიკერია	V,2,SG,IND,PRF
კერავ	V,2,SG,IND,PRS
შეკერე	V,2,SG,IND,PST,PFV
შეგეკერა	V,2,SG,IND,PST,PRF
შეკერო	V,2,SG,OPT
შეკერავდე	V,2,SG,SBJV,FUT
შეგეკეროს	V,2,SG,SBJV,PRF
კერავდე	V,2,SG,SBJV,PRS
შეკერავდნენ	V,3,PL,COND
შეკერონ	V,3,PL,IMP
შეკერავენ	V,3,PL,IND,FUT
კერავდნენ	V,3,PL,IND,IPFV
შეუკერიათ	V,3,PL,IND,PRF
კერავენ	V,3,PL,IND,PRS
შეკერეს	V,3,PL,IND,PST,PFV
შეეკერათ	V,3,PL,IND,PST,PRF
შეკერონ	V,3,PL,OPT
შეკერავდნენ	V,3,PL,SBJV,FUT
შეეკეროთ	V,3,PL,SBJV,PRF
კერავდნენ	V,3,PL,SBJV,PRS
შეკერავდა	V,3,SG,COND
შეკეროს	V,3,SG,IMP
შეკერავს	V,3,SG,IND,FUT
კერავდა	V,3,SG,IND,IPFV
შეუკერია	V,3,SG,IND,PRF
კერავს	V,3,SG,IND,PRS
შეკერა	V,3,SG,IND,PST,PFV
შეეკერა	V,3,SG,IND,PST,PRF
შეკეროს	V,3,SG,OPT
შეკერავდეს	V,3,SG,SBJV,FUT
შეეკეროს	V,3,SG,SBJV,PRF
კერავდეს	V,3,SG,SBJV,PRS

დავადგენდით	V,1,PL,COND
დავადგინოთ	V,1,PL,IMP
დავადგენთ	V,1,PL,IND,FUT
ვადგენდით	V,1,PL,IND,IPFV
დაგვიდგენია	V,1,PL,IND,PRF
ვადგენთ	V,1,PL,IND,PRS
დავადგინეთ	V,1,PL,IND,PST,PFV
დაგვედგინა	V,1,PL,IND,PST,PRF
დავადგინოთ	V,1,PL,OPT
დავადგენდეთ	V,1,PL,SBJV,FUT
დაგვედგინოს	V,1,PL,SBJV,PRF
ვადგენდეთ	V,1,PL,SBJV,PRS
დავადგენდი	V,1,SG,COND
დავადგენ	V,1,SG,IND,FUT
ვადგენდი	V,1,SG,IND,IPFV
დამიდგენია	V,1,SG,IND,PRF
ვადგენ	V,1,SG,IND,PRS
დავადგინე	V,1,SG,IND,PST,PFV
დამედგინა	V,1,SG,IND,PST,PRF
დავადგინო	V,1,SG,OPT
დავადგენდე	V,1,SG,SBJV,FUT
დამედგინოს	V,1,SG,SBJV,PRF
ვადგენდე	V,1,SG,SBJV,PRS
დაადგენდით	V,2,PL,COND
დაადგინეთ	V,2,PL,IMP
დაადგენთ	V,2,PL,IND,FUT
ადგენდით	V,2,PL,IND,IPFV
დაგიდგენიათ	V,2,PL,IND,PRF
ადგენთ	V,2,PL,IND,PRS
დაადგინეთ	V,2,PL,IND,PST,PFV
დაგედგინათ	V,2,PL,IND,PST,PRF
დაადგინოთ	V,2,PL,OPT
დაადგენდეთ	V,2,PL,SBJV,FUT
დაგედგინოთ	V,2,PL,SBJV,PRF
ადგენდეთ	V,2,PL,SBJV,PRS
დაადგენდი	V,2,SG,COND
დაადგინე	V,2,SG,IMP
დაადგენ	V,2,SG,IND,FUT
ადგენდი	V,2,SG,IND,IPFV
დაგიდგენია	V,2,SG,IND,PRF
ადგენ	V,2,SG,IND,PRS
დაადგინე	V,2,SG,IND,PST,PFV
დაგედგინა	V,2,SG,IND,PST,PRF
დაადგინო	V,2,SG,OPT
დაადგენდე	V,2,SG,SBJV,FUT
დაგედგინოს	V,2,SG,SBJV,PRF
ადგენდე	V,2,SG,SBJV,PRS
დაადგენდნენ	V,3,PL,COND
დაადგინონ	V,3,PL,IMP
დაადგენენ	V,3,PL,IND,FUT
ადგენდნენ	V,3,PL,IND,IPFV
დაუდგენიათ	V,3,PL,IND,PRF
ადგენენ	V,3,PL,IND,PRS
დაადგინეს	V,3,PL,IND,PST,PFV
დაედგინათ	V,3,PL,IND,PST,PRF
დაადგინონ	V,3,PL,OPT
დაადგენდნენ	V,3,PL,SBJV,FUT
დაედგინოთ	V,3,PL,SBJV,PRF
ადგენდნენ	V,3,PL,SBJV,PRS
დაადგენდა	V,3,SG,COND
დაადგინოს	V,3,SG,IMP
დაადგენს	V,3,SG,IND,FUT
ადგენდა	V,3,SG,IND,IPFV
დაუდგენია	V,3,SG,IND,PRF
ადგენს	V,3,SG,IND,PRS
დაადგინა	V,3,SG,IND,PST,PFV
დაედგინა	V,3,SG,IND,PST,PRF
დაადგინოს	V,3,SG,OPT
დაადგენდეს	V,3,SG,SBJV,FUT
დაედგინოს	V,3,SG,SBJV,PRF
ადგენდეს	V,3,SG,SBJV,PRS

შევადარებდით	V,1,PL,COND
შევადაროთ	V,1,PL,IMP
შევადარებთ	V,1,PL,IND,FUT
ვადარებდით	V,1,PL,IND,IPFV
შეგვიდარებია	V,1,PL,IND,PRF
ვადარებთ	V,1,PL,IND,PRS
შევადარეთ	V,1,PL,IND,PST,PFV
შეგვედარებინა	V,1,PL,IND,PST,PRF
შევადაროთ	V,1,PL,OPT
შევადარებდეთ	V,1,PL,SBJV,FUT
შეგვედარებინოს	V,1,PL,SBJV,PRF
ვადარებდეთ	V,1,PL,SBJV,PRS
შევადარებდი	V,1,SG,COND
შევადარებ	V,1,SG,IND,FUT
ვადარებდი	V,1,SG,IND,IPFV
შემიდარებია	V,1,SG,IND,PRF
ვადარებ	V,1,SG,IND,PRS
შევადარე	V,1,SG,IND,PST,PFV
შემედარებინა	V,1,SG,IND,PST,PRF
შევადარო	V,1,SG,OPT
შევადარებდე	V,1,SG,SBJV,FUT
შემედარებინოს	V,1,SG,SBJV,PRF
ვადარებდე	V,1,SG,SBJV,PRS
შეადარებდით	V,2,PL,COND
შეადარეთ	V,2,PL,IMP
შეადარებთ	V,2,PL,IND,FUT
ადარებდით	V,2,PL,IND,IPFV
შეგიდარებიათ	V,2,PL,IND,PRF
ადარებთ	V,2,PL,IND,PRS
შეადარეთ	V,2,PL,IND,PST,PFV
შეგედარებინათ	V,2,PL,IND,PST,PRF
შეადაროთ	V,2,PL,OPT
შეადარებდეთ	V,2,PL,SBJV,FUT
შეგედარებინოთ	V,2,PL,SBJV,PRF
ადარებდეთ	V,2,PL,SBJV,PRS
შეადარებდი	V,2,SG,COND
შეადარე	V,2,SG,IMP
შეადარებ	V,2,SG,IND,FUT
ადარებდი	V,2,SG,IND,IPFV
შეგიდარებია	V,2,SG,IND,PRF
ადარებ	V,2,SG,IND,PRS
შეადარე	V,2,SG,IND,PST,PFV
შეგედარებინა	V,2,SG,IND,PST,PRF
შეადარო	V,2,SG,OPT
შეადარებდე	V,2,SG,SBJV,FUT
შეგედარებინოს	V,2,SG,SBJV,PRF
ადარებდე	V,2,SG,SBJV,PRS
შეადარებდნენ	V,3,PL,COND
შეადარონ	V,3,PL,IMP
შეადარებენ	V,3,PL,IND,FUT
ადარებდნენ	V,3,PL,IND,IPFV
შეუდარებიათ	V,3,PL,IND,PRF
ადარებენ	V,3,PL,IND,PRS
შეადარეს	V,3,PL,IND,PST,PFV
შეედარებინათ	V,3,PL,IND,PST,PRF
შეადარონ	V,3,PL,OPT
შეადარებდნენ	V,3,PL,SBJV,FUT
შეედარებინოთ	V,3,PL,SBJV,PRF
ადარებდნენ	V,3,PL,SBJV,PRS
შეადარებდა	V,3,SG,COND
შეადაროს	V,3,SG,IMP
შეადარებს	V,3,SG,IND,FUT
ადარებდა	V,3,SG,IND,IPFV
შეუდარებია	V,3,SG,IND,PRF
ადარებს	V,3,SG,IND,PRS
შეადარა	V,3,SG,IND,PST,PFV
შეედარებინა	V,3,SG,IND,PST,PRF
შეადაროს	V,3,SG,OPT
შეადარებდეს	V,3,SG,SBJV,FUT
შეედარებინოს	V,3,SG,SBJV,PRF
ადარებდეს	V,3,SG,SBJV,PRS

ავაშენებდით	V,1,PL,COND
ავაშენოთ	V,1,PL,IMP
ავაშენებთ	V,1,PL,IND,FUT
ვაშენებდით	V,1,PL,IND,IPFV
აგვიშენებია	V,1,PL,IND,PRF
ვაშენებთ	V,1,PL,IND,PRS
ავაშენეთ	V,1,PL,IND,PST,PFV
აგვეშენებინა	V,1,PL,IND,PST,PRF
ავაშენოთ	V,1,PL,OPT
ავაშენებდეთ	V,1,PL,SBJV,FUT
აგვეშენებინოს	V,1,PL,SBJV,PRF
ვაშენებდეთ	V,1,PL,SBJV,PRS
ავაშენებდი	V,1,SG,COND
ავაშენებ	V,1,SG,IND,FUT
ვაშენებდი	V,1,SG,IND,IPFV
ამიშენებია	V,1,SG,IND,PRF
ვაშენებ	V,1,SG,IND,PRS
ავაშენე	V,1,SG,IND,PST,PFV
ამეშენებინა	V,1,SG,IND,PST,PRF
ავაშენო	V,1,SG,OPT
ავაშენებდე	V,1,SG,SBJV,FUT
ამეშენებინოს	V,1,SG,SBJV,PRF
ვაშენებდე	V,1,SG,SBJV,PRS
ააშენებდით	V,2,PL,COND
ააშენეთ	V,2,PL,IMP
ააშენებთ	V,2,PL,IND,FUT
აშენებდით	V,2,PL,IND,IPFV
აგიშენებიათ	V,2,PL,IND,PRF
აშენებთ	V,2,PL,IND,PRS
ააშენეთ	V,2,PL,IND,PST,PFV
აგეშენებინათ	V,2,PL,IND,PST,PRF
ააშენოთ	V,2,PL,OPT
ააშენებდეთ	V,2,PL,SBJV,FUT
აგეშენებინოთ	V,2,PL,SBJV,PRF
აშენებდეთ	V,2,PL,SBJV,PRS
ააშენებდი	V,2,SG,COND
ააშენე	V,2,SG,IMP
ააშენებ	V,2,SG,IND,FUT
აშენებდი	V,2,SG,IND,IPFV
აგიშენებია	V,2,SG,IND,PRF
აშენებ	V,2,SG,IND,PRS
ააშენე	V,2,SG,IND,PST,PFV
აგეშენებინა	V,2,SG,IND,PST,PRF
ააშენო	V,2,SG,OPT
ააშენებდე	V,2,SG,SBJV,FUT
აგეშენებინოს	V,2,SG,SBJV,PRF
აშენებდე	V,2,SG,SBJV,PRS
ააშენებდნენ	V,3,PL,COND
ააშენონ	V,3,PL,IMP
ააშენებენ	V,3,PL,IND,FUT
აშენებდნენ	V,3,PL,IND,IPFV
აუშენებიათ	V,3,PL,IND,PRF
აშენებენ	V,3,PL,IND,PRS
ააშენეს	V,3,PL,IND,PST,PFV
აეშენებინათ	V,3,PL,IND,PST,PRF
ააშენონ	V,3,PL,OPT
ააშენებდნენ	V,3,PL,SBJV,FUT
აეშენებინოთ	V,3,PL,SBJV,PRF
აშენებდნენ	V,3,PL,SBJV,PRS
ააშენებდა	V,3,SG,COND
ააშენოს	V,3,SG,IMP
ააშენებს	V,3,SG,IND,FUT
აშენებდა	V,3,SG,IND,IPFV
აუშენებია	V,3,SG,IND,PRF
აშენებს	V,3,SG,IND,PRS
ააშენა	V,3,SG,IND,PST,PFV
აეშენებინა	V,3,SG,IND,PST,PRF
ააშენოს	V,3,SG,OPT
ააშენებდეს	V,3,SG,SBJV,FUT
აეშენებინოს	V,3,SG,SBJV,PRF
აშენებდეს	V,3,SG,SBJV,PRS

გავტეხავდით	V,1,PL,COND
გავტეხოთ	V,1,PL,IMP
გავტეხავთ	V,1,PL,IND,FUT
ვტეხავდით	V,1,PL,IND,IPFV
გაგვიტეხია	V,1,PL,IND,PRF
ვტეხავთ	V,1,PL,IND,PRS
გავტეხეთ	V,1,PL,IND,PST,PFV
გაგვეტეხა	V,1,PL,IND,PST,PRF
გავტეხოთ	V,1,PL,OPT
გავტეხავდეთ	V,1,PL,SBJV,FUT
გაგვეტეხოს	V,1,PL,SBJV,PRF
ვტეხავდეთ	V,1,PL,SBJV,PRS
გავტეხავდი	V,1,SG,COND
გავტეხავ	V,1,SG,IND,FUT
ვტეხავდი	V,1,SG,IND,IPFV
გამიტეხია	V,1,SG,IND,PRF
ვტეხავ	V,1,SG,IND,PRS
გავტეხე	V,1,SG,IND,PST,PFV
გამეტეხა	V,1,SG,IND,PST,PRF
გავტეხო	V,1,SG,OPT
გავტეხავდე	V,1,SG,SBJV,FUT
გამეტეხოს	V,1,SG,SBJV,PRF
ვტეხავდე	V,1,SG,SBJV,PRS
გატეხავდით	V,2,PL,COND
გატეხეთ	V,2,PL,IMP
გატეხავთ	V,2,PL,IND,FUT
ტეხავდით	V,2,PL,IND,IPFV
გაგიტეხიათ	V,2,PL,IND,PRF
ტეხავთ	V,2,PL,IND,PRS
გატეხეთ	V,2,PL,IND,PST,PFV
გაგეტეხათ	V,2,PL,IND,PST,PRF
გატეხოთ	V,2,PL,OPT
გატეხავდეთ	V,2,PL,SBJV,FUT
გაგეტეხოთ	V,2,PL,SBJV,PRF
ტეხავდეთ	V,2,PL,SBJV,PRS
გატეხავდი	V,2,SG,COND
გატეხე	V,2,SG,IMP
გატეხავ	V,2,SG,IND,FUT
ტეხავდი	V,2,SG,IND,IPFV
გაგიტეხია	V,2,SG,IND,PRF
ტეხავ	V,2,SG,IND,PRS
გატეხე	V,2,SG,IND,PST,PFV
გაგეტეხა	V,2,SG,IND,PST,PRF
გატეხო	V,2,SG,OPT
გატეხავდე	V,2,SG,SBJV,FUT
გაგეტეხოს	V,2,SG,SBJV,PRF
ტეხავდე	V,2,SG,SBJV,PRS
გატეხავდნენ	V,3,PL,COND
გატეხონ	V,3,PL,IMP
გატეხავენ	V,3,PL,IND,FUT
ტეხავდნენ	V,3,PL,IND,IPFV
გაუტეხიათ	V,3,PL,IND,PRF
ტეხავენ	V,3,PL,IND,PRS
გატეხეს	V,3,PL,IND,PST,PFV
გაეტეხათ	V,3,PL,IND,PST,PRF
გატეხონ	V,3,PL,OPT
გატეხავდნენ	V,3,PL,SBJV,FUT
გაეტეხოთ	V,3,PL,SBJV,PRF
ტეხავდნენ	V,3,PL,SBJV,PRS
გატეხავდა	V,3,SG,COND
გატეხოს	V,3,SG,IMP
გატეხავს	V,3,SG,IND,FUT
ტეხავდა	V,3,SG,IND,IPFV
გაუტეხია	V,3,SG,IND,PRF
ტეხავს	V,3,SG,IND,PRS
გატეხა	V,3,SG,IND,PST,PFV
გაეტეხა	V,3,SG,IND,PST,PRF
გატეხოს	V,3,SG,OPT
გატეხავდეს	V,3,SG,SBJV,FUT
გაეტეხოს	V,3,SG,SBJV,PRF
ტეხავდეს	V,3,SG,SBJV,PRS

